#tileWidth=35,,,,,,,,,,,,,
#tileHeight=35,,,,,,,,,,,,,
0,0,0,0,0,0,0,0,0,0,0,0,0,0,0,0,0,0,0,0,0,0,0,0,0,0,0,0,0,0,0,0,0,0,0,0,0,0,0,0,0,0,0,0,0,0,0,0,0,0,0,0,0,0,0,0,
0,0,0,0,0,0,0,1,1,0,0,0,0,0,0,0,0,0,0,0,0,1,1,0,0,0,0,0,0,0,0,0,0,0,0,1,1,0,0,0,0,0,0,0,0,0,0,0,0,1,1,0,0,0,0,0,
0,0,0,0,0,0,1,2,2,1,0,0,0,0,0,0,0,0,0,0,1,2,2,1,0,0,0,0,3,0,0,0,0,0,1,2,2,1,0,0,0,0,0,0,0,0,0,0,1,2,2,1,0,0,0,0,
0,0,0,0,0,1,2,2,2,2,1,0,0,0,0,0,0,0,0,1,2,2,2,2,1,0,0,3,3,3,0,0,0,1,2,2,2,2,1,0,0,0,0,0,0,0,0,1,2,2,2,2,1,0,0,0,
1,1,1,1,1,2,2,2,2,2,2,1,1,1,1,0,0,0,1,2,2,2,2,2,2,1,3,3,3,3,3,1,1,2,2,2,2,2,2,1,1,1,1,1,1,1,1,2,2,2,2,2,2,1,1,1,
>assets/grassMid.png,ground,,,,,,,,,,,,
>assets/grassCenter.png,ground,,,,,,,,,,,,
>assets/liquidLava.png,lava,,,,,,,,,,,,
